02 01 01 01 01 01 01 01 01 03 00 00 00 02 01 01 01 01 01 01 01 01 01 01 01 03 00 00 00 00 02 01 01 01 01 01 01 01 01 01 03 00 00 00 00 00 00 00 00 00
02 25 25 25 25 25 25 25 25 03 00 00 00 02 25 25 25 25 25 25 25 25 25 25 25 03 00 00 00 00 02 25 25 25 25 25 25 25 25 25 03 00 00 00 00 00 00 00 00 00
02 25 25 25 25 25 25 25 25 03 00 00 00 02 25 25 25 25 25 25 25 25 25 25 25 03 00 00 00 00 02 25 25 25 25 25 25 25 25 25 03 00 00 00 00 00 00 00 00 00
02 25 25 25 25 25 25 25 25 01 01 01 01 01 25 25 25 25 25 25 25 25 25 25 25 01 01 01 01 01 01 25 25 25 25 25 25 25 25 25 03 00 00 00 00 00 00 00 00 00
02 25 25 25 25 25 25 25 25 25 25 25 25 25 25 25 25 25 25 25 25 25 25 25 25 25 25 25 25 25 25 25 25 25 25 25 25 25 25 25 03 00 00 00 00 00 00 00 00 00
02 25 25 25 25 25 25 25 25 25 25 25 25 25 25 25 25 25 25 25 25 25 25 25 25 25 25 25 25 25 25 25 25 25 25 25 25 25 25 25 03 00 00 00 00 00 00 00 00 00
02 25 25 25 25 25 25 25 25 07 01 01 01 08 25 25 25 25 25 25 25 25 25 25 25 07 01 01 01 01 08 25 25 25 25 25 25 25 25 25 03 00 00 00 00 00 00 00 00 00
02 25 25 25 25 25 25 25 25 03 00 00 00 02 25 25 25 25 25 25 25 25 25 25 25 03 00 00 00 00 02 25 25 25 25 25 25 25 25 25 03 00 00 00 00 00 00 00 00 00
02 25 25 25 25 25 25 25 25 03 00 00 00 02 25 25 25 25 25 25 25 25 25 25 25 03 00 00 00 00 02 25 25 25 25 25 25 25 25 25 03 00 00 00 00 00 00 00 00 00
06 01 01 08 25 25 07 01 01 05 00 00 00 02 25 25 25 25 25 25 25 25 25 25 25 03 00 00 00 00 02 25 25 25 25 25 25 25 25 25 03 00 00 00 00 00 00 00 00 00
00 00 00 02 25 25 03 00 00 00 00 00 00 02 25 25 25 25 25 25 25 25 25 25 25 03 00 00 00 00 02 25 25 25 25 25 25 25 25 25 03 00 00 00 00 00 00 00 00 00
00 00 00 02 25 25 03 00 00 00 00 00 00 06 01 08 25 25 07 01 01 01 01 01 01 05 00 00 00 00 06 01 01 01 08 25 25 07 01 01 05 00 00 00 00 00 00 00 00 00
00 00 00 02 25 25 03 00 00 00 00 00 00 00 00 02 25 25 03 00 00 00 00 00 00 00 00 00 00 00 00 00 00 00 02 25 25 03 00 00 00 00 00 00 00 00 00 00 00 00
00 00 00 02 25 25 03 00 00 00 00 00 00 00 00 02 25 25 03 00 00 00 00 00 00 00 00 00 00 00 00 00 00 00 02 25 25 03 00 00 00 00 00 00 00 00 00 00 00 00
02 01 01 01 25 25 01 01 01 03 00 00 00 02 01 01 25 25 01 01 01 01 01 01 01 03 00 00 00 00 00 00 00 00 02 25 25 03 00 00 00 00 00 00 00 00 00 00 00 00
02 25 25 25 25 25 25 25 25 03 00 00 00 02 25 25 25 25 25 25 25 25 25 25 25 03 00 00 00 00 00 00 00 00 02 25 25 03 00 00 00 00 00 00 00 00 00 00 00 00
02 25 25 25 25 25 25 25 25 03 00 00 00 02 25 25 25 25 25 25 25 25 25 25 25 03 00 00 00 00 00 00 00 00 02 25 25 03 00 00 00 00 00 00 00 00 00 00 00 00
02 25 25 10 10 10 10 25 25 01 01 01 01 01 25 25 25 25 25 25 25 25 25 25 25 03 00 00 00 00 00 00 00 00 02 25 25 03 00 00 00 00 00 00 00 00 00 00 00 00
02 25 25 11 11 11 11 25 25 25 25 25 25 25 25 25 25 25 25 25 25 25 25 25 25 03 00 00 00 00 00 00 00 00 02 25 25 03 00 00 00 00 00 00 00 00 00 00 00 00
02 25 25 11 11 11 11 25 25 25 25 25 25 25 25 25 25 25 25 25 25 25 25 25 25 03 00 00 00 00 00 00 00 00 02 25 25 03 00 00 00 00 00 00 00 00 00 00 00 00
02 25 25 11 11 11 11 25 25 07 01 01 01 08 25 25 25 25 25 25 25 25 25 25 25 03 00 00 00 00 00 00 00 00 02 25 25 03 00 00 00 00 00 00 00 00 00 00 00 00
02 25 25 25 25 25 25 25 25 03 00 00 00 02 25 25 25 25 25 25 25 25 25 25 25 03 00 00 00 00 00 00 00 00 02 25 25 03 00 00 00 00 00 00 00 00 00 00 00 00
02 25 25 25 25 25 25 25 25 03 00 00 00 02 25 25 25 25 25 25 25 25 25 25 25 03 00 00 00 00 00 00 00 00 02 25 25 03 00 00 00 00 00 00 00 00 00 00 00 00
06 01 01 08 25 25 07 01 01 05 00 00 00 02 25 25 25 25 25 25 25 25 25 25 25 03 00 00 00 02 01 01 01 01 01 25 25 01 01 01 01 01 03 00 00 00 00 00 00 00
00 00 00 02 25 25 03 00 00 00 00 00 00 02 25 25 25 25 25 25 25 25 25 25 25 03 00 00 00 02 25 25 25 25 25 25 25 25 25 25 25 25 03 00 00 00 00 00 00 00
00 00 00 02 25 25 03 00 00 00 00 00 00 06 01 01 01 01 01 01 01 01 01 01 01 05 00 00 00 02 25 25 25 25 25 25 25 25 25 25 25 25 03 00 00 00 00 00 00 00
00 00 00 02 25 25 03 00 00 00 00 00 00 00 00 00 00 00 00 00 00 00 00 00 00 00 00 00 00 02 25 25 25 25 25 25 25 25 25 25 25 25 03 00 00 00 00 00 00 00
00 00 00 02 25 25 03 00 00 00 00 00 00 00 00 00 00 00 00 00 00 00 00 00 00 00 00 00 00 02 25 25 25 25 25 25 25 25 25 25 25 25 03 00 00 00 00 00 00 00
02 01 01 01 25 25 01 01 01 01 01 01 03 00 00 00 00 00 00 00 00 00 00 00 00 00 00 00 00 02 25 25 25 25 25 25 25 25 25 25 25 25 03 00 00 00 00 00 00 00
02 25 25 25 25 25 25 25 25 25 25 25 03 00 00 00 00 00 00 00 00 00 00 00 00 00 00 00 00 02 25 25 25 25 25 25 25 25 25 25 25 25 03 00 00 00 00 00 00 00
02 25 25 25 25 25 25 25 25 25 25 25 03 00 00 00 00 00 00 00 00 00 00 00 00 00 00 00 00 02 25 25 25 25 25 25 25 25 25 25 25 25 03 00 00 00 00 00 00 00
02 25 25 25 25 25 25 25 25 25 25 25 03 00 00 00 00 00 00 00 00 00 00 00 00 00 00 00 00 02 25 25 25 25 25 25 25 25 25 25 25 25 03 00 00 00 00 00 00 00
02 25 25 25 25 25 25 25 25 25 25 25 03 00 00 00 00 00 00 00 00 00 00 00 00 00 00 00 00 02 25 25 25 25 25 25 25 25 25 25 25 25 03 00 00 00 00 00 00 00
02 25 25 25 25 25 25 25 25 25 25 25 03 00 00 00 00 00 00 00 00 00 00 00 00 00 00 00 00 02 25 25 25 25 25 25 25 25 25 25 25 25 03 00 00 00 00 00 00 00
02 25 25 25 25 25 25 25 25 25 25 25 03 00 00 00 00 00 00 00 00 00 00 00 00 00 00 00 00 02 25 25 25 25 25 25 25 25 25 25 25 25 03 00 00 00 00 00 00 00
02 25 25 25 25 25 25 25 25 25 25 25 03 00 00 00 00 00 00 00 00 00 00 00 00 00 00 00 00 02 25 25 25 25 25 25 25 25 25 25 25 25 03 00 00 00 00 00 00 00
02 25 25 25 25 25 25 25 25 25 25 25 03 00 00 00 00 00 00 00 00 00 00 00 00 00 00 00 00 06 01 01 01 01 01 01 01 01 01 01 01 01 05 00 00 00 00 00 00 00
02 25 25 25 25 25 25 25 25 25 25 25 03 00 00 00 00 00 00 00 00 00 00 00 00 00 00 00 00 00 00 00 00 00 00 00 00 00 00 00 00 00 00 00 00 00 00 00 00 00
06 01 01 01 01 01 01 01 01 01 01 01 05 00 00 00 00 00 00 00 00 00 00 00 00 00 00 00 00 00 00 00 00 00 00 00 00 00 00 00 00 00 00 00 00 00 00 00 00 00
00 00 00 00 00 00 00 00 00 00 00 00 00 00 00 00 00 00 00 00 00 00 00 00 00 00 00 00 00 00 00 00 00 00 00 00 00 00 00 00 00 00 00 00 00 00 00 00 00 00
00 00 00 00 00 00 00 00 00 00 00 00 00 00 00 00 00 00 00 00 00 00 00 00 00 00 00 00 00 00 00 00 00 00 00 00 00 00 00 00 00 00 00 00 00 00 00 00 00 00
00 00 00 00 00 00 00 00 00 00 00 00 00 00 00 00 00 00 00 00 00 00 00 00 00 00 00 00 00 00 00 00 00 00 00 00 00 00 00 00 00 00 00 00 00 00 00 00 00 00
00 00 00 00 00 00 00 00 00 00 00 00 00 00 00 00 00 00 00 00 00 00 00 00 00 00 00 00 00 00 00 00 00 00 00 00 00 00 00 00 00 00 00 00 00 00 00 00 00 00
00 00 00 00 00 00 00 00 00 00 00 00 00 00 00 00 00 00 00 00 00 00 00 00 00 00 00 00 00 00 00 00 00 00 00 00 00 00 00 00 00 00 00 00 00 00 00 00 00 00
00 00 00 00 00 00 00 00 00 00 00 00 00 00 00 00 00 00 00 00 00 00 00 00 00 00 00 00 00 00 00 00 00 00 00 00 00 00 00 00 00 00 00 00 00 00 00 00 00 00
00 00 00 00 00 00 00 00 00 00 00 00 00 00 00 00 00 00 00 00 00 00 00 00 00 00 00 00 00 00 00 00 00 00 00 00 00 00 00 00 00 00 00 00 00 00 00 00 00 00
00 00 00 00 00 00 00 00 00 00 00 00 00 00 00 00 00 00 00 00 00 00 00 00 00 00 00 00 00 00 00 00 00 00 00 00 00 00 00 00 00 00 00 00 00 00 00 00 00 00
00 00 00 00 00 00 00 00 00 00 00 00 00 00 00 00 00 00 00 00 00 00 00 00 00 00 00 00 00 00 00 00 00 00 00 00 00 00 00 00 00 00 00 00 00 00 00 00 00 00
00 00 00 00 00 00 00 00 00 00 00 00 00 00 00 00 00 00 00 00 00 00 00 00 00 00 00 00 00 00 00 00 00 00 00 00 00 00 00 00 00 00 00 00 00 00 00 00 00 00
00 00 00 00 00 00 00 00 00 00 00 00 00 00 00 00 00 00 00 00 00 00 00 00 00 00 00 00 00 00 00 00 00 00 00 00 00 00 00 00 00 00 00 00 00 00 00 00 00 00
00 00 00 00 00 00 00 00 00 00 00 00 00 00 00 00 00 00 00 00 00 00 00 00 00 00 00 00 00 00 00 00 00 00 00 00 00 00 00 00 00 00 00 00 00 00 00 00 00 00
00 00 00 00 00 00 00 00 00 00 00 00 00 00 00 00 00 00 00 00 00 00 00 00 00 00 00 00 00 00 00 00 00 00 00 00 00 00 00 00 00 00 00 00 00 00 00 00 00 00
00 00 00 00 00 00 00 00 00 00 00 00 00 00 00 00 00 00 00 00 00 00 00 00 00 00 00 00 00 00 00 00 00 00 00 00 00 00 00 00 00 00 00 00 00 00 00 00 00 00